111111111111111111111111111111111111111111111111111
1C001000C0000000100C0010000001C0000C000000000000011
11101110000000C111000011000011111000111001111C00111
1C10001111000011C0000001100110001110011100111100101
100000001110000100000001000C00000111000110011100001
1011001100110011001010011011101C00011000100000100C1
11110000000C000000000000000000C11000111111100011001
1C00000011111111111100000C111111000001111000011E001
1111100000000C100000000000000001000000C010000011111
1P1111C000001110011100001111111111110000010001100C1
100000000011C00001100000000000000000000000000000111
111111111111111111111111111111111111111111111111111