111111111111111111111111111111111111111111111111111
1C001000C0000000100C00100M0001C0000C00000000000M011
111011100000M0C111000011000011111M00111001111C00111
1C10001111000011C0000001100110001110011100111100101
100000001110000100000001000C0000M11100M1100111M0001
1011M01100110011001010011011101C000110C0100000100C1
11110000000C000000000M00000000C110001111111000110M1
1C00000M11111111111100000C111111M00001111000011E001
1111100000000C100000000000000001000000C0100M0011111
1P1111C00000111001110000111111111111M000010001100C1
100000000011C0000110M0000000000000000000000M0000111
111111111111111111111111111111111111111111111111111