1111111111111
10010000000C1
10C0011111001
1P0011E000101
1111111111111