1111111111111
10010000000C1
10C00111110M1
1P0M11C0000E1
1111111111111